人生短暂，赚钱永恒。	财富论坛	新资本家
一切向钱看，才能向前看。	市场经济论坛	改革先驱者	
盗版VCD和游戏软件很便宜，创业不妨从倒卖它们开始.	发财之道	中关村人		
伪劣化妆品经常给您惊喜。	发财之道	一个富婆	
人们啊！不要总是把目光放在便宜的货物上，要及时买卖贵物品，承担风险的同时赚大钱。	财神语录
进多种货物，发展多种经营，可以避免风险。	《MBA速成》	John Smith
您欠村长的钱，利息是10%.所以要赶快还掉，免得有债务危机。	村务公开	高家庄新闻
把握好给村长还钱的时机：还钱太早，您自己资金周转困难，还钱太晚，高利息让人受不了。	善意的提示
山西假白酒价格在1500元时可以买进了。	发财之道	一个老酒鬼		12
进口玩具价格在400元以下，可以大肆进货.	经验之谈	先富起来的人	12
走私汽车能够赚大钱，但是有时风险太大。	促进北京汽车消费	胡说者		13
谨慎！禁书《上海小宝贝》有时可以赚大钱（5000元左右买进），但是对青少年成长不利。	保护青少年	卫秽
进口香烟的平均价格好象是200元，很赚钱喔。	吸烟有害	烟草害人局
水货手机低于1200元时是发财好机会。	发展北京通信产业	吴鸡传
有时汽车能够让您赚500%的利润。	发财者言
银行的利息是很低的：只有1%。但是还是要经常存钱，以免发生意外。	给市民的建议	银行
原始积累很必要，但是也很残酷。	《资本新论》	马克丝
胆子要大一点，脸皮要厚一点。	《赚钱黑厚学》	一个骗子
游戏必须是免费的、共享的、开放源代码的！	“我们的理念”	Guoly Computing公司总裁
您可以给我们发电子邮件，讨论任何问题。地址在“关于本游戏”中。	“为您服务”	Guoly Computing公司总裁




